Tom offered Mary a glass of wine.	Tomás le ofreció una copa de vino a María.	
Tom offered to lend me the money.	Tom ofreció pasarme el dinero.	            
Tom often fails to keep his word.	Tom a menudo no mantiene su palabra.	    
Tom often suffers from headaches.	Tom sufre a menudo de dolores de cabeza.	
Tom opened his eyes and saw Mary.	Tom abrió los ojos y vio a María.	        
Tom passed away during the night.	Tom murió durante la noche.	                
Tom plays flute in the orchestra.	Tom toca la flauta en la orquesta.	        
Tom postponed his trip to Boston.	Tom postergó su viaje a Boston.	            
Tom poured himself another glass.	Tom se sirvió otro vaso.	                
You must respect senior citizens.	Debes respetar a los mayores.	            
You need to believe in something.	Necesitas creer en algo.	                
You neglected to say "Thank you."	Se te olvidó decir, "gracias."	            
You never wanted to be my friend.	Nunca quisiste ser mi amigo.	            
You ought to get to work on time.	Debes llegar al trabajo a tiempo.	        
You ought to just tell the truth.	Deberías decir la verdad.	                
You really don't want to do this.	Realmente no quieres hacer esto.	        
You really have an ear for music.	Verdaderamente tienes oído para la música.	
You really have an ear for music.	Realmente tienes un oído para la música.	
You really loved Tom, didn't you?	Realmente querías a Tom, ¿no?	  
I thank you for your sympathy.	    Te agradezco tu simpatía.	          
I thank you with all my heart.	    Te lo agradezco de todo corazón.	  
I thank you with all my heart.	    Te agradezco de todo corazón.	      
I think I did something wrong.	    Creo que hice algo malo.	          
I think I have it figured out.	    Creo que tengo todo resuelto.         
I think I need some more time.	    Creo que necesito algo más de tiempo.
I think I remember doing that.	    Creo que recuerdo haciendo eso.     
I think I'd like to live here.	    Creo que me gustaría vivir aquí.	  
I think I'm going to throw up.	    Creo que voy a vomitar.	              
I think I'm gonna go to sleep.	    Creo que me voy a ir a la cama.     
I think I've been here before.	    Creo que ya he estado aquí antes.	  
I think I've done that before.	    Creo que lo he hecho antes.         
I think I've had one too many.	    Creo que he tomado uno de más.	      
I think Tom is from Australia.	    Creo que Tom es de Australia.	      
